2,2,2,2,2,2,2,2,2,2,2,2,2,2,2,2,2,2,2,2,2,2,2,2,2,2,2,2
2,2,2,2,2,2,2,2,2,2,2,2,2,2,2,2,2,2,2,2,2,2,2,2,2,2,2,2
2,2,2,2,2,2,2,2,2,2,2,2,2,2,2,2,2,2,2,2,2,2,2,2,2,2,2,2
3,3,3,3,3,3,3,3,3,3,3,2,2,2,2,2,2,2,2,2,2,2,3,3,3,3,3,3
3,3,3,3,3,3,3,3,3,3,3,2,2,2,2,2,2,2,2,2,2,2,3,3,3,3,3,3
2,2,2,2,2,2,2,2,2,3,3,2,2,2,2,2,2,2,2,2,2,2,3,3,2,2,2,2
2,2,2,2,2,2,4,5,2,3,3,2,2,2,2,2,2,2,2,2,2,2,3,3,2,2,2,2
2,2,2,2,2,2,6,7,2,3,3,2,2,2,2,2,2,2,2,2,2,2,3,3,2,2,2,2
2,2,2,2,2,2,2,2,2,3,3,2,2,2,2,2,2,2,2,2,2,2,3,3,2,2,2,2
2,2,2,2,2,2,2,2,2,3,3,2,2,2,2,2,2,2,2,2,2,2,3,3,2,2,2,2
2,2,2,2,2,2,2,2,2,3,3,2,2,2,2,2,2,2,2,2,2,2,3,3,2,2,2,2
2,2,2,2,2,2,2,2,2,3,3,3,3,3,3,3,3,3,3,2,2,2,3,3,2,2,2,2
2,2,2,2,2,2,2,2,2,3,3,3,3,3,3,3,3,3,3,2,2,2,3,3,2,2,2,2
2,2,2,2,2,2,2,2,2,3,3,2,2,2,2,2,2,3,3,2,2,2,3,3,2,2,2,2
2,2,2,2,2,2,2,2,2,3,3,2,2,2,2,2,2,3,3,2,2,2,3,3,2,2,2,2
2,2,2,2,2,2,2,2,2,3,3,2,2,2,2,2,2,3,3,3,3,3,3,3,2,2,2,2
2,2,2,2,2,2,2,2,2,3,3,2,2,2,2,2,2,3,3,3,3,3,3,3,2,2,2,2
2,2,2,2,2,2,2,2,2,3,3,2,2,2,2,2,2,3,3,2,2,2,2,2,2,2,2,2
2,2,2,2,2,2,2,2,2,3,3,2,2,2,2,2,2,3,3,2,2,2,2,2,2,2,2,2
2,2,2,2,2,2,2,2,2,3,3,3,3,3,3,3,3,3,3,2,2,2,2,2,2,2,2,2
2,2,2,2,2,2,2,2,2,3,3,3,3,3,3,3,3,3,3,2,2,2,2,2,2,2,2,2
2,2,2,2,2,2,2,2,2,2,2,2,2,2,2,2,2,2,2,2,2,2,2,2,2,2,2,2
2,2,2,2,2,2,2,2,2,2,2,2,2,2,2,2,2,2,2,2,2,2,2,2,2,2,2,2
